[
  {
    "type": "overmap_terrain",
    "id": [ "office_doctor", "office_doctor_1", "office_doctor_2" ],
    "copy-from": "generic_city_building",
    "looks_like": "office_doctor",
    "name": "doctor's office",
    "color": "i_light_red",
    "extend": { "flags": [ "SOURCE_MEDICINE" ] }
  },
  {
    "type": "overmap_terrain",
    "id": [ "office_doctor_roof", "office_doctor_roof_1", "office_doctor_roof_2", "office_doctor_upper_roof_2" ],
    "copy-from": "generic_city_building",
    "looks_like": "office_doctor_roof",
    "name": "doctor's office roof",
    "color": "i_light_red"
  },
  {
    "type": "city_building",
    "id": "office_doctor_2",
    "locations": [ "land" ],
    "overmaps": [
      { "point": [ 0, 0, 0 ], "overmap": "office_doctor_2_north" },
      { "point": [ 0, 0, 1 ], "overmap": "office_doctor_roof_2_north" },
      { "point": [ 0, 0, 2 ], "overmap": "office_doctor_upper_roof_2_north" }
    ]
  },
  {
    "type": "mapgen",
    "method": "json",
    "om_terrain": [ "office_doctor_2" ],
    "weight": 200,
    "object": {
      "fill_ter": "t_dirt",
      "rows": [
        "    ~~                  ",
        "    ~~                  ",
        " #0#::#0###########0### ",
        " #y......YYYt#YYYoeccS# ",
        " #ccccc.....Y#.......c0 ",
        " #..Wrc...t.Y#......ht# ",
        " 0..........Y#CtT...ht# ",
        " ######..########!##### ",
        " #&...+............+.I# ",
        " #r..S#............#.I# ",
        " #######!########!##### ",
        " #S.ol#...#lo.S#.....f# ",
        " #....!...!....#.hh..f# ",
        " 0...t#...#t...#.ddd..0 ",
        " #.W.B#...#B.W.#yrA..o# ",
        " #######!############## ",
        "  #u!...........X....H# ",
        "  ####+###+####5#....H# ",
        "    #c..#....c###OOO.H# ",
        "    #S..'.?/..c######## ",
        "    #S..#.....c#4       ",
        "    ############        ",
        "                        ",
        "                        "
      ],
      "palettes": [ "office_doctor" ],
      "terrain": { "?": "t_floor", "/": "t_floor", "Y": "t_floor", "A": "t_floor", "R": "t_floor", "'": "t_door_glass_o" },
      "furniture": { "?": "f_autodoc", "/": "f_autodoc_couch", "Y": "f_sofa", "T": "f_table", "A": "f_armchair", "R": "f_trashcan" },
      "computers": {
        "5": {
          "name": "Medical Supply Access",
          "security": 2,
          "options": [ { "name": "Unlock Door", "action": "unlock" } ],
          "failures": [ { "action": "shutdown" }, { "action": "alarm" } ]
        }
      },
      "items": {
        "B": { "item": "hospital_bed", "chance": 60 },
        "R": { "item": "trash", "chance": 50 },
        "o": { "item": "doctors_books", "chance": 60 },
        "e": { "item": "SUS_fridge_breakroom", "chance": 80 },
        "C": { "item": "dresser", "chance": 75 },
        "O": { "item": "bionics", "chance": 40 },
        "T": { "item": "office_breakroom", "chance": 80 },
        "f": { "item": "SUS_office_filing_cabinet", "chance": 90 },
        "H": [
          { "item": "harddrugs", "chance": 60 },
          { "item": "gear_medical", "chance": 60, "repeat": [ 1, 3 ] },
          { "item": "drugs_analgesic", "chance": 60, "repeat": [ 1, 3 ] },
          { "item": "drugs_rare", "chance": 60 },
          { "item": "surgery", "chance": 60 }
        ],
        "?": { "item": "autodoc_supplies", "chance": 100 }
      },
      "place_loot": [
        { "group": "waitingroom", "x": 12, "y": 3, "chance": 70, "repeat": [ 1, 3 ] },
        { "group": "waitingroom", "x": 10, "y": 5, "chance": 70, "repeat": [ 1, 3 ] },
        { "group": "dining", "x": 21, "y": [ 5, 6 ], "chance": 65, "repeat": [ 1, 3 ] },
        { "group": "office", "x": [ 17, 19 ], "y": 13, "chance": 80, "repeat": [ 1, 2 ] },
        { "group": "cleaning", "x": 21, "y": [ 8, 9 ], "chance": 70, "repeat": [ 1, 2 ] },
        { "group": "surgery", "x": 14, "y": [ 19, 20 ], "chance": 70, "repeat": [ 1, 2 ] },
        { "group": "gear_medical", "x": 14, "y": [ 19, 20 ], "chance": 70, "repeat": [ 1, 2 ] },
        { "group": "alcohol", "x": 21, "y": 11, "chance": 70 },
        { "group": "magazines", "x": 17, "y": 3, "chance": 90, "repeat": [ 2, 8 ] },
        { "item": "microwave", "x": 21, "y": 4, "chance": 85 },
        { "item": "laptop", "x": 4, "y": 4, "chance": 85 },
        { "item": "television", "x": 15, "y": 6, "chance": 95 },
        { "item": "soap", "x": 5, "y": 18, "chance": 95 },
        { "item": "anesthetic_kit", "x": 13, "y": 18, "chance": 75, "ammo": 100 }
      ],
      "vehicles": { "W": { "vehicle": "swivel_chair", "chance": 100, "status": 1 } }
    }
  },
  {
    "type": "mapgen",
    "method": "json",
    "om_terrain": "office_doctor_roof_2",
    "object": {
      "fill_ter": "t_floor",
      "rows": [
        "                        ",
        "                        ",
        " |222222222222222222223 ",
        " |....................3 ",
        " |....................3 ",
        " |........o...........3 ",
        " |....................3 ",
        " |....................3 ",
        " |....................3 ",
        " |....................3 ",
        " |......#w##w##w##....3 ",
        " |.######bt#bt#bt#....3 ",
        " |.#f__f#__#__#__#....3 ",
        " |.#f__f#+##+##+##....3 ",
        " |.#f__f#________#....3 ",
        " |###+###_########A...3 ",
        "  #>____+_+_____L#A...3 ",
        "  #w##w##_#y_/?_t#....3 ",
        "    |..4##########....3 ",
        "    |.....&=...5------3 ",
        "    |..........3        ",
        "    |----------3        ",
        "                        ",
        "                        "
      ],
      "terrain": {
        ".": "t_flat_roof",
        "=": "t_flat_roof",
        "&": "t_flat_roof",
        "A": "t_flat_roof",
        " ": "t_open_air",
        "o": "t_glass_roof",
        "2": "t_gutter",
        "-": "t_gutter",
        "3": "t_gutter",
        "|": "t_gutter",
        ">": "t_stairs_down",
        "#": "t_wall_b",
        "_": "t_floor",
        "w": "t_wall_glass",
        "+": "t_door_glass_frosted_lab_c",
        "4": "t_gutter_downspout",
        "5": "t_gutter_drop"
      },
      "furniture": {
        "&": "f_roof_turbine_vent",
        "=": "f_vent_pipe",
        "b": "f_bed",
        "t": "f_table",
        "c": "f_armchair",
        "f": "f_filing_cabinet",
        "?": "f_autodoc",
        "L": "f_locker",
        "/": "f_autodoc_couch",
        "y": [ "f_indoor_plant_y", "f_indoor_plant" ],
        "A": "f_air_conditioner"
      },
      "items": {
        "b": { "item": "hospital_bed", "chance": 60 },
        "f": { "item": "SUS_office_filing_cabinet", "chance": 70 },
        "L": [
          { "item": "harddrugs", "chance": 60, "repeat": [ 1, 3 ] },
          { "item": "gear_medical", "chance": 60, "repeat": [ 1, 3 ] },
          { "item": "drugs_analgesic", "chance": 60, "repeat": [ 1, 3 ] },
          { "item": "drugs_rare", "chance": 60 },
          { "item": "surgery", "chance": 60 }
        ],
        "?": { "item": "autodoc_supplies", "chance": 100 }
      }
    }
  },
  {
    "type": "mapgen",
    "method": "json",
    "om_terrain": "office_doctor_upper_roof_2",
    "object": {
      "fill_ter": "t_flat_roof",
      "rows": [
        "                        ",
        "                        ",
        "                        ",
        "                        ",
        "                        ",
        "                        ",
        "                        ",
        "                        ",
        "                        ",
        "                        ",
        "        |222222223      ",
        "   |2222|........3      ",
        "   |..........:..3      ",
        "   |.X...........3      ",
        "   |.............3      ",
        "  ||.............3      ",
        "  |........oooo..3      ",
        "  |-----5........3      ",
        "        |--------3      ",
        "                        ",
        "                        ",
        "                        ",
        "                        ",
        "                        "
      ],
      "terrain": {
        ".": "t_flat_roof",
        " ": "t_open_air",
        "o": "t_glass_roof",
        "2": "t_gutter",
        "-": "t_gutter",
        "3": "t_gutter",
        "|": "t_gutter",
        "5": "t_gutter_drop"
      },
      "furniture": { ":": "f_cellphone_booster", "X": "f_small_satellite_dish" }
    }
  }
]
