[
  {
    "type": "mapgen",
    "method": "json",
    "om_terrain": [
      [
        "lab_surface_brick_block5A0",
        "lab_surface_brick_block5B0",
        "lab_surface_brick_block5C0",
        "lab_surface_brick_block5D0",
        "lab_surface_brick_block5E0"
      ],
      [
        "lab_surface_brick_block5A1",
        "lab_surface_brick_block5B1",
        "lab_surface_brick_block5C1",
        "lab_surface_brick_block5D1",
        "lab_surface_brick_block5E1"
      ],
      [
        "lab_surface_brick_block5A2",
        "lab_surface_brick_block5B2",
        "lab_surface_brick_block5C2",
        "lab_surface_brick_block5D2",
        "lab_surface_brick_block5E2"
      ],
      [
        "lab_surface_brick_block5A3",
        "lab_surface_brick_block5B3",
        "lab_surface_brick_block5C3",
        "lab_surface_brick_block5D3",
        "lab_surface_brick_block5E3"
      ],
      [
        "lab_surface_brick_block5A4",
        "lab_surface_brick_block5B4",
        "lab_surface_brick_block5C4",
        "lab_surface_brick_block5D4",
        "lab_surface_brick_block5E4"
      ]
    ],
    "object": {
      "fill_ter": "t_flat_roof",
      "rows": [
        "........................................................................................................................",
        "........................................................................................................................",
        "........................................................................................................................",
        "........................................................................................................................",
        "........................................................................................................................",
        "........................................................................................................................",
        "........................................................................................................................",
        "........................................................................................................................",
        "........................................................................................................................",
        "........................................................................................................................",
        "........................................................................................................................",
        "........................................................................................................................",
        "........................................................................................................................",
        "........................................................................................................................",
        "........................................................................................................................",
        "........................................................................................................................",
        "........................................................................................................................",
        "........................................................................................................................",
        "........................................................................................................................",
        "........................................................................................................................",
        "........................................................................................................................",
        "........................................................................................................................",
        "........................................................................................................................",
        "........................................................................................................................",
        "........................................................................................................................",
        "........................................................................................................................",
        "........................................................................................................................",
        "........................................................................................................................",
        "........................................................................................................................",
        "........................................................................................................................",
        "..........._________________________________................................_________________________________...........",
        "..........._____________________AA__________................................__________AA_____________________...........",
        "...........__(__________________pp__________................................__________pp__________________(__...........",
        "..........._____________________pp__________................................__________pp_____________________...........",
        "...........______________>______aa__________................................__________aa______>______________...........",
        "..........._________________________________................................_________________________________...........",
        "..........._________________________________................................_________________________________...........",
        "..........._________________________________................................_________________________________...........",
        "..........._________________________________................................_________________________________...........",
        "..........._________________________________................................_________________________________...........",
        "..........._________________________________................................_________________________________...........",
        "...........___((P_____________________P((___................................___((P_____________________P((___...........",
        "...........___((pppV_______________Vppp((___................................___((pppV_______________Vppp((___...........",
        "..........._________________________________................................_________________________________...........",
        "..........._________________________________................................_________________________________...........",
        "..........._________________________________................................_________________________________...........",
        "..........._________________________________................................_________________________________...........",
        "..........._________________________________................................_________________________________...........",
        "..........._________________________________................................_________________________________...........",
        "..........._________________________________................................_________________________________...........",
        "..........._________________________________................................_________________________________...........",
        "..........._________________________________................................_________________________________...........",
        "..........._________________________________................................_________________________________...........",
        "...........___AA_______________________AA___................................___AA_______________________AA___...........",
        "...........___AApppa_______v_______apppAA___................................___AApppa_______v_______apppAA___...........",
        "..........._________________________________................................_________________________________...........",
        "..........._________________________________................................_________________________________...........",
        "..........._________________________________................................_________________________________...........",
        "..........._________________________________................................_________________________________...........",
        "..........._________________________________................................_________________________________...........",
        "..........._________________________________................................_________________________________...........",
        "..........._________________________________................................_________________________________...........",
        "..........._________________________________................................_________________________________...........",
        "..........._________________________________................................_________________________________...........",
        "..........._________________________________................................_________________________________...........",
        "..........._________________________________................................_________________________________...........",
        "..........._________________________________................................_________________________________...........",
        "...........___((P_____________________P((___................................_________________________________...........",
        "...........___((ppp_________________ppp((___................................___((P_____________________P((___...........",
        "..........._________________________________................................___((ppp_________________ppp((___...........",
        "..........._________________________________................................_________________________________...........",
        "..........._________________________________................................_________________________________...........",
        "..........._________________________________................................_________________________________...........",
        "..........._________________________________................................_________________________________...........",
        "..........._________________________________................................_________________________________...........",
        "..........._________________________________................................_________________________________...........",
        "..........._________________________________................................_________________________________...........",
        "..........._________________________________................................_________________________________...........",
        "..........._________________________________................................_________________________________...........",
        "...........___AA_______________________AA___................................_________________________________...........",
        "...........___AApppa_______v_______apppAA___................................___AA_______________________AA___...........",
        "..........._________________________________................................___AApppa_______v_______apppAA___...........",
        "..........._________________________________................................_________________________________...........",
        "..........._________________________________................................_________________________________...........",
        "..........._________________________________................................_________________________________...........",
        "..........._________________________________................................_________________________________...........",
        "..........._________________________________................................_________________________________...........",
        "..........._________________________________................................_________________________________...........",
        "..........._________________________________................................_________________________________...........",
        "..........._________________________________................................_________________________________...........",
        "..........._________________________________................................_________________________________...........",
        "..........._________________________________................................_________________________________...........",
        "..........._________________________________................................_________________________________...........",
        "..........._________________________________................................_________________________________...........",
        "..........._________________________________................................_________________________________...........",
        "...........___AA_______________________AA___................................___AA_______________________AA___...........",
        "...........___AApppa_______v_______apppAA___................................___AApppa_______v_______apppAA___...........",
        "..........._________________________________................................_________________________________...........",
        "..........._________________________________................................_________________________________...........",
        "..........._________________________________................................_________________________________...........",
        "..........._________________________________................................_________________________________...........",
        "...........__________________________________..............................__________________________________...........",
        "...........________________________________V________________________________V________________________________...........",
        "...........___________________________________S((______________________((S___________________________________...........",
        "...........____________________________________((______________________((____________________________________...........",
        "...........__________________________________________________________________________________________________...........",
        "...........________________________________________________AA________________________________________________...........",
        "..........._____________________________________________pppAAppp_____________________________________________...........",
        "..........._____________________________________________p______p_____________________________________________...........",
        "..........._((P_____________________________________v__aa______aa__v_____________________________________P((_...........",
        "..........._((pppV_____________________________________aa______aa_____________________________________Vppp((_...........",
        "...........__________________________________________________________________________________________________...........",
        "........................................................................................................................",
        "........................................................................................................................",
        "........................................................................................................................",
        "........................................................................................................................",
        "........................................................................................................................",
        "........................................................................................................................",
        "........................................................................................................................",
        "........................................................................................................................"
      ],
      "palettes": [ "lab_roof_palette" ]
    }
  },
  {
    "type": "palette",
    "id": "lab_roof_palette",
    "terrain": {
      ".": "t_open_air",
      "#": "t_brick_wall",
      "|": "t_strconc_wall",
      " ": "t_strconc_floor",
      "%": "t_linoleum_white",
      "+": "t_door_c",
      "-": "t_door_glass_frosted_c",
      "=": "t_door_glass_frosted_lab_c",
      ":": "t_reinforced_glass",
      ";": "t_window",
      "_": "t_flat_roof",
      ",": "t_glass_roof",
      "/": "t_chainfence",
      "^": "t_fence_barbed",
      "!": "t_guardrail_bg_dp",
      "m": "t_door_metal_c",
      "M": "t_door_metal_locked",
      "p": "t_sewage_pipe",
      "]": "t_sidewalk",
      "*": "t_region_shrub_decorative",
      "<": "t_stairs_up",
      ">": "t_stairs_down",
      "e": "t_elevator",
      "@": "t_elevator_control_off",
      "V": "t_radio_tower"
    },
    "furniture": {
      "&": "f_trashcan",
      "{": "f_glass_fridge",
      "1": [ "f_indoor_plant", "f_indoor_plant_y" ],
      "(": "f_satellite",
      "a": "f_standing_tank",
      "A": "f_air_conditioner",
      "b": "f_bench",
      "B": "f_bookcase",
      "C": "f_counter",
      "c": "f_chair",
      "d": "f_desk",
      "E": "f_eyewash",
      "f": "f_fridge",
      "h": "f_sofa",
      "H": "f_shower",
      "l": "f_locker",
      "L": "f_locker",
      "o": "f_oven",
      "P", "f_solar_unit2",
      "r": "f_rack",
      "S": "f_sink",
      "s": "f_stool",
      "t": "f_table",
      "v": "f_vent_pipe",
      "x": "f_console_broken"
    },
    "toilets": { "T": {  } },
    "vendingmachines": { "D": { "item_group": "vending_drink" }, "F": { "item_group": "vending_food" } }
  }
]
